24 0 0 0 21 0 0 0
0 1 0 0 22 0 0 0
11 0 1 0 0 0 23 0
0 12 1 0 0 0 0 0
0 0 1 1 0 0 0 0
0 13 0 0 0 0 0 0
0 0 0 0 0 14 0 0 0
0 0 0 0 0 0 0 0